hhn: zom ilo ihy
ckq: wyv ypn
kze: ysu fvm
ucw: vyd fta wgs caz
xmc: ugt ewf auu
lnt: toj lcx
xhs: out
vcs: fyq lyz asr
hqh: zjx
wyv: jjm voy
pmb: hnk qto
znd: qxu zta
ypn: qxn jjm voy
hhz: uzb oah
rdw: out
tra: ygt kki ser wac sxj zbv
nkh: fta vyd wgs
fwn: zet qxk
nvs: rqe gvi
xth: mob uuf
puz: miw fft wyb
jri: hhf
ygt: ydz non
dgo: dgy cii
jzi: hwr pbj mzg
brp: tgp vup yfz
asr: exs
nyl: lsd
qma: xdm kyb cza pyw vwc eea aqx frl
yjy: xnd dyu
qau: ndd lsu
tql: eom qfv qdc lre
gav: ouk fwn oat
dyc: out
xhh: xtz zlv
ume: eox
ltr: otp xnd pqt
tki: txy
wzu: suy wgf kyp spm
cvp: dac bmc pma qiw
oeu: wgs vyd fta caz
wut: mag qoo ucw
ars: yzz
zay: fmd
mmc: ysu edr
wyb: cna xth
lra: yfe
ley: lrt tql hba
bhg: bgx lra npo hte swg agi dlx mps hqh xxz bqq vqd ucp yzq
xck: qxn voy
mrr: fik dsg
olk: gya ser auz aju mtv ygt kze mkq sxj mmc xtr xgh tkq zbv hpg kki rhi kgv
zom: seo tvc dpu
jrv: avf
oer: voy qxn
zii: out
dac: mwe rej
wlb: vcs ncq iuz
gfo: dij lsd alj qed
wbp: uxb brp mgw
nzj: zrf vyd
lzk: jdu kpl hrj
vas: evx ytm
eim: caz vyd zrf
mlp: xmc hcz ops pwg
rzy: zii sfx lsu ndd
qed: bhg jxx qdw gep
voy: lvs pdr djy nvf xni cjs zay ysg gvt zpm omn bvp waj
yfe: ouk oat unp
sfx: out
qnt: frv
quz: wgs
jof: pcw uzb kac
ttb: eyk
auz: rtp
osv: uwu
xge: nyz gdf
wnn: yah
lrt: qfv eom
xnv: nas fki oon
wjc: ula bxw eox
drg: oeu
hrj: toj lcx
pwg: auu ugt
upl: jxm pes cqm
uwh: zjo
mob: zrf wgs vyd fta caz
wzr: rzy
ula: you
vqd: xul
ubo: out
rkd: pmb jzh jpp
nuz: oer bur
sxj: stc yyi nwr ezc
qtl: due
oon: wgs zrf vyd caz
jxm: wjv uot awg xck
qbo: kac oah
pqt: pov mab
vzi: out
ugv: skf uoq vyy
ysh: lkk dpb rvy
vmz: skf vyy thy
cpa: dge
jvx: mzg pph
nig: mgc mob quz
npd: rhk
fvm: xay ars mmp
jtr: yvw rrp
unp: qma qxk zet
ugp: zcq pnz ieu
pgf: ihu bdq ukn vwt
qxk: afq vyr nfq skd
bvp: wut drg dpa
wpd: jjm
the: wzu
agi: mvr wqb owq tgu ivj
hca: vtf nga ici rdw
gch: spk tgp
gmh: tki drj
hte: lcw bqn
ncz: xnv
fft: nqm nig
non: sby ify rat
svr: tra kpe gbr olk ngv
zfq: out
ayy: afa ckq vhj axz
yfa: vam zcq pnz
rdt: nuz
sbo: qxn
qke: kwy lnh rjw
thy: caz vyd fta wgs
hye: rqe qef gvi
dcj: wut oxz dpa
bxw: you txy
xtz: zet qxk
pfr: bwg
ezc: afa ckq vhj ccv axz
avf: jci
yzq: zjx gav yfe
nlt: rmb zfb fvr
dtc: uoq
itr: rwu uem jrv qvy ide eyg yao oem rkd qrd emv hmh zwa noz qnf ldb trq ufe qbo ffx pxo omf hhz jof
dek: toj
zta: mdm nwd
rvy: zcv ksj yfr
msk: yfa ugp bya
zcq: qdw gep bhg jxx
yfz: you
lgl: hrj
xnd: mab pov
die: yws qxu
ldb: cls jzi fba jvx
hws: rhk gch mgw brp
bgx: lcw wzu bqn
kmk: gep jxx
cjs: eoc bxt
cna: qio quz
ccv: wcc
len: cpq yly
hqe: vzi wcn dyc bwz
ihy: tvc
rif: jxm pes
zcv: bhg jxx qdw
mur: alj bjh qed dij lsd
ihu: qxy
yzz: voy
wgs: vxy txf kcs mjw pgl fxt msk svh
jzh: nvs hye
eyg: omg
vyy: vyd zrf
uuf: caz fta wgs
exs: uoq vyy thy skf
vyd: etr mlp ojv pob kcs msk wsz
ncx: rrp due pho
nqm: mgc uuf qio quz
xtr: stc yyi nwr ezc ayy
lks: dyu otp
ieu: gep qdw jxx
tgu: xhh
mvr: esi
lkk: ksj
ecd: yls zak
mho: yfa gev ugp
hcz: auu
czi: out
omf: zld kac pcw oah
auu: dod wgi gfo
uip: qcw wjg gck
sfu: vqo dpb fsr
nfq: bok qtl
cmr: kmk hhf
kkf: sfx lsu
ncg: puz
zld: nlh die znd
llj: hnn czi thi jwk
pvt: you itr txy
mdm: zfq wcn vzi
yfr: bhg qdw gep
bok: pho due rrp
vtf: out
wqb: wep
xvy: tce bzh jri cmr gaz
xfq: uqw nns xwm dgy
wsz: jsd hwj mqz
lsu: out
bya: mie ieu vam
ajb: bhg qdw gep
uot: qxn
ukn: jjo ajb
ucp: rcz gdf ghg
pxo: jzi fba
ndp: dpb rvy
yly: yls
yin: fvr wzr rmb
fba: kuh
pnz: qdw gep bhg
qhm: nkh mgq
tpg: drj tki uug lcu
kac: die uuz znd
pho: ume
qfv: out
pcw: znd nlh die
kuh: pmh wnn
rrp: kvr wjc
wjv: jjm voy
spm: qxk
qxy: qdw gep bhg
fyi: cmr bzh
poz: dhh
ify: jjm qxn
bzh: dqq kmk
fps: daw mgq
noz: weo rlf
nyz: vas yhw hbl
axz: wyv sbo ypn wcc
lgp: qxn jjm
djy: poz qin efv ofv
nyk: lcu tki uug
yen: hwr pph pbj mzg
xay: vgk mrc yzz
xqf: lzk hlq tnd
afq: wbp npd
kki: axh ydz rtp zmn
pyw: qsa ays
vay: owb
bvo: dpf xfq dgo ern ubq
mkq: stc nwr yyi ayy
ble: itr
wxj: yfa gev bya ugp
wgi: qed alj bjh lsd dij
pdr: puz eoc bxt
yzr: tce
pph: ley akb pmh
bqn: suy kyp udt
qrd: wgy
ryx: rjw fps
kgk: bxw
jab: ubo rdw nga ici
gdf: hbl vas
aeh: hba tql lrt
evx: qma rnz
gya: igr rdt
uug: txy itr
due: kgk kvr wjc vay
fki: zrf wgs fta vyd caz
irw: uip
tgs: mrr cwl
tvc: jxx bhg gep
zwa: tom wgy
omn: rzp yae xqf
ivj: xhh
bjh: gep qdw jxx bhg
bpi: hnn czi thi jwk
qwx: qxn
uzb: die
xwi: fdw xvy yzr lug fyi
emv: tom wgy
mie: bhg jxx
mgq: caz wgs zrf vyd fta
kvr: ula eox owb
mps: ghg rcz
qiw: ble rej
zfb: kkf
dpu: qdw bhg jxx
rmb: qau
zlv: rnz zet qxk qma
xni: kwy fps rjw qhm
vhj: ypn wyv sbo
jtb: jzh
yhw: snx
stc: ccv axz ckq afa vhj
ysu: mmp xay
oxz: eim ucw
oem: jpp ule
rat: jjm qxn voy
vua: out
rtp: rat
qxu: mdm nwd
wpr: mhf
rwu: omg lks yjy ltr
nlh: qxu yws
rjw: daw
bmc: ble mwe xyd zde
iuz: fyq cvh asr
kfz: zom ilo ttb
avn: ici
awg: voy
eoc: miw fft
gck: xhs dge sxk
txy: qnf ldb qbo brk jof ffx uem ufe jtb
lre: out
lyz: kgj vmz ugv dtc exs
mgw: yfz tgp spk
kyp: qma
ntf: mgc uuf mob qio
owq: esi wep xhh
wac: rif upl aqs
ewf: nyl mur wgi
qoo: zrf fta caz
uem: omg lks
gev: zcq pnz vam
etg: spm udt wgf
qxn: gvt cwo cvw ryx omn bvp lvs djy xni nvf qdi ysg ncg lqp dcj zpm ums wpr qke pdr wlb cjs zay
jor: npd wbp
rhk: tgp spk vup yfz
gcu: rzn hwj
ksj: qdw
gic: rvy vqo fsr
wjg: dge sxk qeu xhs
bqq: ghg
bsl: eye nas usc fki
vqo: yfr ksj zcv
tkq: non axh
vxy: gev
ern: xwm
pma: xyd
hbl: evx snx ytm
yls: qma qxk rnz zet
dyu: mab pov
skf: caz vyd zrf
xgh: nuj
qvy: rlf avf
kgj: uoq thy
ngv: gya ser xtr wac auz xgh hpg acm
wcn: out
etr: ops cnf hcz pwg xmc
esi: xtz btz
uxb: vup yfz tgp spk
oat: qma rnz zet
zmn: sby ify qwx
nuj: qfx
eyk: gep bhg jxx
zkk: ivj tgu wqb mvr
cvw: bxt
aju: zmn
gvi: llj way
ays: mgv pvt
ncq: lyz fyq cvh
nwr: vhj afa ckq axz ccv
aqs: pes cqm
ifa: jab avn
xyd: txy
nns: you itr
cqm: awg uot wjv xck
lqp: ofv poz eod
dpa: oeu ucw mag
asg: rzn
vwt: jjo
pes: awg wjv lgp xck
lcw: spm suy
ymg: qxy
kgv: rdt
akb: tql lrt yah hba
nqa: cqm
cvf: qdw gep bhg
tnd: kpl hrj lnt jdu
svh: ilo ihy ttb
yah: qdc vua qfv lre eom
dij: jxx gep qdw
vwq: bvo dsg
pgl: xvy fdw lug
vam: gep qdw
wgy: eji uwh aff
cvh: kgj vmz ugv exs
otp: mab pov ifa
ums: ofv qin poz
hmh: jzh pmb jpp
rzn: ndp ysh sfu
ixg: eye
kpe: ygt kze hpg zbv xtr wac auz xgh mmc ser
cpq: yls icg zak
est: hpi sqc vff pfr
cnf: ugt
rnz: tgs aqx zms xdm kyb cza vwc wdp ykc skd fse afq xhm nfq jor cvp
cwo: rjw fps kwy
dlx: xul len
suy: fhn zet qxk qma
swg: mvr ivj
qin: ncz zpa dhh
nas: zrf wgs fta
drj: itr you
hhf: jxx bhg
unu: sqc hpi pfr vff
hlq: dek
vup: you itr
udt: rnz qma qxk
qto: qef
jjo: bhg jxx gep
qsa: mgv
tom: aff irw
mag: zrf
vff: nzg rdq pgf
daw: caz wgs
qcw: xhs qeu sxk
cza: pma
owb: itr txy
bpc: gev
eaq: yly cpq
ffx: yjy lks
fse: tpg nyk gmh
frl: jtr ncx
cwl: fik
vwc: qiw
ytm: rnz zet qma qxk
rnu: qnt ncx
mmp: mrc vgk
bwg: ymg vwt ukn
eea: pma dac bmc
gep: mps yzq swg ucp vqd nby the bgx lra
lsd: jxx bhg gep qdw
zpm: dpa drg oxz wut
ser: igr nuj
miw: ntf nqm nig xth
uqw: txy itr
mjw: yzr xvy fdw lug
mzg: akb wnn aeh
kpl: toj nzj lcx
lvs: ofv efv eod poz qin
yvw: vay ume wjc kgk kvr
mhf: cvh fyq
hnk: qef rqe
rdq: ymg vwt bdq ihu
xxz: zjx
thi: out
fxt: fyi fdw
ojv: pwg cnf xmc
qdi: dpa oxz wut
ici: out
ule: qto
nzg: vwt ukn
nby: len eaq xul
rzp: lzk tnd
mwe: itr txy you
pbj: akb wnn aeh
trq: zld pcw
rej: you txy
hwj: sfu fes ndp
zde: itr txy you
mtv: aqs rif upl nqa
ufe: fba cls yen
dge: out
alj: qdw bhg
xul: ecd cpq yly
frv: wjc
lcx: caz vyd fta zrf wgs
jxx: bqq the hqh zkk yzq npo
btz: zet rnz qma fhn
gbr: mmc auz xgh gya aju rhi kgv
kcs: ihy
fvr: qau kkf rzy
eox: txy
snx: fhn rnz zet
eji: anh
uwu: mgv pvt xzo
rhi: igr rdt
bxt: wyb fft
uoq: fta
jdu: lcx nzj
sxk: out
zak: fhn rnz qxk
rcz: hbl vas yhw
igr: qfx doa nuz
ubq: cii dgy xwm nns
yyi: ccv afa
fsr: zcv tsu yfr
fdw: bzh tce
rqe: bpi
dgy: itr
dqq: bhg gep
lug: gaz tce bzh
dsg: xfq dpf ubq dgo ern
xzo: itr txy you
pez: vwt ymg
afa: wcc wyv sbo
fmd: lgl
zrf: xwi bpc txf mjw
pob: hpi sqc pfr
vyr: vwq cwl
npo: wzu etg lcw
spk: txy
aqx: hws npd wbp
skd: dac pma
ysg: drg dpa oxz wut
doa: oer wpd
pov: jab
anh: wjg cpa
kyb: bok jtr qnt ncx
usc: caz vyd fta wgs
qnf: ltr yjy
qfx: bur
ndd: out
bwz: out
wcc: voy
axl: aff uwh eji
weo: nlt
hba: qfv qdc eom
hnn: out
qdw: bgx lra the hte nby npo dlx swg agi mps bqq xxz xge ucp yzq
wgf: fhn qma rnz
kwy: daw
dhh: bsl xnv
jci: zfb wzr fvr
you: noz qvy ide qrd rwu omf hmh zwa trq
toj: wgs caz
cls: hwr pph kuh mzg
ffr: jxx bhg qdw gep
acm: edr
wdp: qsa
uuz: zta qxu yws
tgp: itr
fes: vqo fsr
odx: mqz
fyq: ugv
ghg: vas yhw
vgk: qxn
qef: llj way
ilo: eyk dpu
bdq: jjo
yws: nwd hqe
edr: xay
jsd: gic ysh ndp
dod: qed bjh
fta: kcs txf est pgl wsz kfz xwi vxy ojv unu svh odx gcu mjw hhn mho asg wxj bpc mlp pob
jwk: out
oah: nlh uuz znd
gvt: vcs mhf iuz
ide: wgy tom
fik: ern xfq
mrc: jjm qxn
sby: voy qxn
seo: bhg qdw gep
zms: cwl vwq
hpg: nqa
waj: xqf
xdm: gmh
yao: wgy axl
yae: lzk hlq lgl tnd
dpb: yfr ffr ksj tsu
qio: fta vyd zrf caz
gaz: cvf dqq hhf
icg: zet rnz qxk qma fhn
mab: hca avn
lnh: mgq daw
nga: out
sqc: nzg bwg pez
caz: asg mho hhn mjw pob etr fxt wsz kcs txf est vxy unu ojv xwi kfz odx svh gcu
aff: anh zjo uip
mgc: caz fta wgs zrf
rlf: nlt jci yin
qeu: out
pmh: hba
qdc: out
ugt: gfo wgi mur dod
zbv: ysu edr
xwm: itr txy
jjm: gvt lqp zpm dcj ums cwo bvp omn ryx cvw waj wpr pdr qke lvs djy wlb xni nvf cjs qdi ncg ysg
lcu: you txy itr
dpf: xwm nns dgy uqw
omg: pqt otp dyu
zpa: xnv ixg
brk: rlf weo avf
eom: out
hwr: wnn pmh aeh ley
eod: zpa ncz
tce: kmk cvf
nwd: vzi zfq dyc bwz
mqz: fes
ouk: zet rnz qxk fhn
hpi: bwg pgf
ykc: nyk tpg gmh
axh: qwx ify
xhm: gmh
ops: ewf
txf: xmc ops cnf
fhn: nfq xhm jor eea fse vwc wdp osv xdm kyb pyw vyr zms
efv: dhh
wep: xtz zlv
jpp: qto nvs
zet: osv rnu pyw vwc wdp tgs xhm cvp ykc skd eea
bur: qxn voy
eye: caz vyd
way: czi hnn thi
zjo: gck
ydz: qwx
cii: itr
nvf: fps kwy qhm
zjx: fwn
mgv: you txy
tsu: qdw
ofv: zpa ncz
